Space ship
Ambience
11111111111111111
11111111110000001
11111100000000001
11110000000000001
11100000000000001
11100000000000001
11000000000000001
11100000000000000
11100000000000000
11100000000000000
11000000000000001
11100000000000001
11100000000000001
11110000000000001
11111100000000001
11111111110000001
11111111111111111