Fallen Capital
ToadTownRuins
11111110001111111
11111100000000001
11111100000111001
11111100000111001
11111100000000001
11111100011100001
11111100011100001
11111100011100000
11000000000000000
11001100000000000
10001100100000001
10001100100011001
10001100100011001
10011100100011001
10001100000000001
10001100000000001
11111110001111111