Test zone
DebugSong
11111111111111111111
10000000000000000001
10000000000000000001
10000001111111111001
10000000000000001001
10000001111111101001
10000000000000101001
10000000000000101001
10000000011000000001
10000000011000000001
10000000000000000001
10000000000000000001
10000000000000000001
10000000000000000001
10000000000000000001
10000000000000000001
10000000000000000001
10000000000000000001
10000000000000000001
11111111111111111111