A.L.I.E.N.'s Lair
ShroobilanMischief
11111110001111111
10000000000000001
11100010001000111
11100000000000111
10000010001000001
11100000000000111
11100010001000111
10000000000000001
11100000000000111
11100001110000111
10000001110000001
11100001110000111
11100000000000111
10000011111000001
11100011111000111
11100011111000111
11111111111111111