Molten Woods
ToadwoodForest
11111111111111111
11111110011000001
11111110011011111
11111000011011111
11111000111000111
11111000111000111
10000000111110111
00000000011110111
00001000000000111
00000000000000111
10001100000000111
10001100000000111
10011100000000111
10011100000011111
10001110000011111
10001110000011111
11111110001111111