Snowy Peaks
Route216
11111111111111111
10000000000000001
10100000000000101
10100001000000101
10000001000000001
10000000000100001
10000000000100001
00000001000000001
00001000000000001
00000001001000001
10000000001000001
10000001001011111
10010001001000001
10010000001000001
10000000001000001
10000000001000001
11111111111111111